NO ./assets/wall_n.xpm
SO ./assets/wall_s.xpm
WE ./assets/wall_w.xpm
EA ./assets/wall_e.xpm
F 224,172,105
C 205,249,255
		1111111111111111111111111
		10000000001100000000000011
		1011000001110000000000001
		10010000000000000000000011
111111111011000001110000000000001
100000000011000001111110111111111
11110111111111011100000000001
11110111111111011100000000001
110000001101010111000000N0001
10000000000000001100000000001
10000000000000001101000000001
1100000111010101111111111111111
11110111 1110101 101111010001
11111111 1111111 111111111111